11111111111111111111111111111111111111111111111111
100000000000000000P0000C0000C000000C00C00C0C0E0011
10000000000000000000000C0000C000000C00C00C0C000011
11111111111111111111111111111111111111111111111111
