11111111111111111111111111111111111111111111111111
100000000000000000000P0000000000000000000000C0E001
11111111111111111111111111111111111111111111111111
