11111111111111111111111111111111111111111111111111
1000000001P00000000000000000C000000C00C00C0C0E0011
11111111111111111111111111111111111111111111111111