11111111111111111111111111111111111111111111111111
100000000100000000000P0000000000000000000000100001
100E0000010000000000000000000000000000000001C10001
11110111110000000000000000000000000000000000C00001
10000000010000000000000000000000000000000000C00001
10000000010000000000000000000000000000000000C00001
10000000000000000000000000000000000000000000C00001
11111111111111111111111111111111111111111111111111
