11111111111111111111111111111111111111111111111111
10E000000000000000000P00000000C0000000000000000001
100000000000000000000000000000C0000000000000000001
100000000000000000000000000000C0000000000000000001
100000000000000000000000000000C0000000000000000001
100000000000000000000000000000C0000000000000000001
100000000000000000000000000000C0000000000000000001
100000000000000000000000000000C0000000000000000001
100000000000000000000000000000C0000000000000000001
100000000000000000000000000000C0000000000000000001
100000000000000000000000000000C0000000000000000001
100000000000000000000000000000C0000000000000000001
100000000000000000000000000000C0000000000000000001
100000000000000000000000000000C0000000000000000001
100000000000000000000000000000C0000000000000000001
100000000000000000000000000000C0000000000000000001
100000000000000000000000000000C0000000000000000001
100000000000000000000000000000C0000000000000000001
100000000000000000000000000000C0000000000000000001
100000000000000000000000000000C0000000000000000001
100000000000000000000000000000C0000000000000000001
100000000000000000000000000000C0000000000000000001
100000000000000000000000000000C0000000000000000001
100000000000000000000000000000C0000000000000000001
100000000000000000000000000000C0000000000000000001
100000000000000000000000000000C0000000000000000001
100000000000000000000000000000C0000000000000000001
100000000000000000000000000000C0000000000000000001
100000000000000000000000000000C0000000000000000001
100000000000000000000000000000C0000000000000000001
100000000000000000000000000000C0000000000000000001
100000000000000000000000000000C0000000000000000001
100000000000000000000000000000C0000000000000000001
100000000000000000000000000000C0000000000000000001
100000000000000000000000000000C0000000000000000001
100000000000000000000000000000C0000000000000000001
100000000000000000000000000000C0000000000000000001
100000000000000000000000000000C0000000000000000001
100000000000000000000000000000C0000000000000000001
100000000000000000000000000000C0000000000000000001
100000000000000000000000000000C0000000000000000001
100000000000000000000000000000C0000000000000000001
100000000000000000000000000000C0000000000000000001
100000000000000000000000000000C0000000000000000001
100000000000000000000000000000C0000000000000000001
100000000000000000000000000000C0000000000000000001
100000000000000000000000000000C0000000000000000001
100000000000000000000000000000C0000000000000000001
11111111111111111111111111111111111111111111111111
