11111111111111111111111111111111111111111111111111111111111111111111111111111111
1000P0000000000000000000000000C0000000000000000001111111111111111111111111111111
100000000000000000000000000000C0000000000000000001111111111111111111111111111111
100000000000000000000000000000C0000000000000000001111111111111111111111111111111
100000000000000000000000000000C0000000000000000001111111111111111111111111111111
100000000000E00000000000000000C0000000000000000001111111111111111111111111111111
100000000000000000000000000000C0000000000000000001111111111111111111111111111111
100000000000000000000000000000C0000000000000000001111111111111111111111111111111
100000000000000000000000000000C0000000000000000001111111111111111111111111111111
100000000000000000000000000000C0000000000000000001111111111111111111111111111111
100000000000000000000000000000C0000000000000000001111111111111111111111111111111
100000000000000000000000000000C0000000000000000001111111111111111111111111111111
100000000000000000000000000000C0000000000000000001111111111111111111111111111111
100000000000000000000000000000C0000000000000000001111111111111111111111111111111
100000000000000000000000000000C0000000000000000001111111111111111111111111111111
100000000000000000000000000000C0000000000000000001111111111111111111111111111111
100000000000000000000000000000C0000000000000000001111111111111111111111111111111
100000000000000000000000000000C0000000000000000001111111111111111111111111111111
100000000000000000000000000000C0000000000000000001111111111111111111111111111111
100000000000000000000000000000C0000000000000000001111111111111111111111111111111
100000000000000000000000000000C0000000000000000001111111111111111111111111111111
100000000000000000000000000000C0000000000000000001111111111111111111111111111111
100000000000000000000000000000C0000000000000000001111111111111111111111111111111
100000000000000000000000000000C0000000000000000001111111111111111111111111111111
100000000000000000000000000000C0000000000000000001111111111111111111111111111111
100000000000000000000000000000C0000000000000000001111111111111111111111111111111
100000000000000000000000000000C0000000000000000001111111111111111111111111111111
100000000000000000000000000000C0000000000000000001111111111111111111111111111111
100000000000000000000000000000C0000000000000000001111111111111111111111111111111
100000000000000000000000000000C0000000000000000001111111111111111111111111111111
100000000000000000000000000000C0000000000000000001111111111111111111111111111111
100000000000000000000000000000C0000000000000000001111111111111111111111111111111
100000000000000000000000000000C0000000000000000001111111111111111111111111111111
100000000000000000000000000000C0000000000000000001111111111111111111111111111111
100000000000000000000000000000C0000000000000000001111111111111111111111111111111
100000000000000000000000000000C0000000000000000001111111111111111111111111111111
100000000000000000000000000000C0000000000000000001111111111111111111111111111111
100000000000000000000000000000C0000000000000000001111111111111111111111111111111
100000000000000000000000000000C0000000000000000001111111111111111111111111111111
100000000000000000000000000000C0000000000000000001111111111111111111111111111111
100000000000000000000000000000C0000000000000000001111111111111111111111111111111
100000000000000000000000000000C0000000000000000001111111111111111111111111111111
100000000000000000000000000000C0000000000000000001111111111111111111111111111111
100000000000000000000000000000C0000000000000000001111111111111111111111111111111
100000000000000000000000000000C0000000000000000001111111111111111111111111111111
11111111111111111111111111111111111111111111111111111111111111111111111111111111